s   ###   # ###
#  #  ###   # #
##   ## ###   #
#  ##   ### ###
  ##  #   # # #
#    #  #     #
####  ## #### #
#  #  ## # ## #
  ### #  # ####
#  #  ##   ####
##  #    ### ##
   #  ##  ##   
##   ##    #  #
#  ### ###   ##
##   #     #  f